0 clocks
Final PC Value : 0x  400008


  	 	 ********************* CORE DUMP ********************* 	 	 
REG[000] : 0x00000000 	REG[001] : 0x00000001 	REG[002] : 0x00000000 	REG[003] : 0x00000000 	
REG[004] : 0x00000000 	REG[005] : 0x00000000 	REG[006] : 0x00000000 	REG[007] : 0x00000000 	
REG[008] : 0x00000000 	REG[009] : 0x00000000 	REG[010] : 0x00000000 	REG[011] : 0x00000000 	
REG[012] : 0x00000000 	REG[013] : 0x00000000 	REG[014] : 0x00000000 	REG[015] : 0x00000000 	
REG[016] : 0x00000000 	REG[017] : 0x00000000 	REG[018] : 0x00000000 	REG[019] : 0x00000000 	
REG[020] : 0x00000000 	REG[021] : 0x00000000 	REG[022] : 0x00000000 	REG[023] : 0x00000000 	
REG[024] : 0x00000000 	REG[025] : 0x00000000 	REG[026] : 0x00000000 	REG[027] : 0x00000000 	
REG[028] : 0x00000000 	REG[029] : 0x00000000 	REG[030] : 0x00000000 	REG[031] : 0x00000000 	
	****************************************************************************

  	 	 ********************* MEMORY DUMP ********************* 	 	 
MEM[000] : 0x00000000 	MEM[001] : 0x00000000 	MEM[002] : 0x00000000 	MEM[003] : 0x00000000 	
MEM[004] : 0x00000000 	MEM[005] : 0x00000000 	MEM[006] : 0x00000000 	MEM[007] : 0x00000000 	
MEM[008] : 0x00000000 	MEM[009] : 0x00000000 	MEM[010] : 0x00000000 	MEM[011] : 0x00000000 	
MEM[012] : 0x00000000 	MEM[013] : 0x00000000 	MEM[014] : 0x00000000 	MEM[015] : 0x00000000 	
MEM[016] : 0x00000000 	MEM[017] : 0x00000000 	MEM[018] : 0x00000000 	MEM[019] : 0x00000000 	
MEM[020] : 0x00000000 	MEM[021] : 0x00000000 	MEM[022] : 0x00000000 	MEM[023] : 0x00000000 	
MEM[024] : 0x00000000 	MEM[025] : 0x00000000 	MEM[026] : 0x00000000 	MEM[027] : 0x00000000 	
MEM[028] : 0x00000000 	MEM[029] : 0x00000000 	MEM[030] : 0x00000000 	MEM[031] : 0x00000000 	
MEM[032] : 0x00000000 	MEM[033] : 0x00000000 	MEM[034] : 0x00000000 	MEM[035] : 0x00000000 	
MEM[036] : 0x00000000 	MEM[037] : 0x00000000 	MEM[038] : 0x00000000 	MEM[039] : 0x00000000 	
MEM[040] : 0x00000000 	MEM[041] : 0x00000000 	MEM[042] : 0x00000000 	MEM[043] : 0x00000000 	
MEM[044] : 0x00000000 	MEM[045] : 0x00000000 	MEM[046] : 0x00000000 	MEM[047] : 0x00000000 	
MEM[048] : 0x00000000 	MEM[049] : 0x00000000 	MEM[050] : 0x00000000 	MEM[051] : 0x00000000 	
MEM[052] : 0x00000000 	MEM[053] : 0x00000000 	MEM[054] : 0x00000000 	MEM[055] : 0x00000000 	
MEM[056] : 0x00000000 	MEM[057] : 0x00000000 	MEM[058] : 0x00000000 	MEM[059] : 0x00000000 	
MEM[060] : 0x00000000 	MEM[061] : 0x00000000 	MEM[062] : 0x00000000 	MEM[063] : 0x00000000 	
MEM[064] : 0x00000000 	MEM[065] : 0x00000000 	MEM[066] : 0x00000000 	MEM[067] : 0x00000000 	
MEM[068] : 0x00000000 	MEM[069] : 0x00000000 	MEM[070] : 0x00000000 	MEM[071] : 0x00000000 	
MEM[072] : 0x00000000 	MEM[073] : 0x00000000 	MEM[074] : 0x00000000 	MEM[075] : 0x00000000 	
MEM[076] : 0x00000000 	MEM[077] : 0x00000000 	MEM[078] : 0x00000000 	MEM[079] : 0x00000000 	
MEM[080] : 0x00000000 	MEM[081] : 0x00000000 	MEM[082] : 0x00000000 	MEM[083] : 0x00000000 	
MEM[084] : 0x00000000 	MEM[085] : 0x00000000 	MEM[086] : 0x00000000 	MEM[087] : 0x00000000 	
MEM[088] : 0x00000000 	MEM[089] : 0x00000000 	MEM[090] : 0x00000000 	MEM[091] : 0x00000000 	
MEM[092] : 0x00000000 	MEM[093] : 0x00000000 	MEM[094] : 0x00000000 	MEM[095] : 0x00000000 	
MEM[096] : 0x00000000 	MEM[097] : 0x00000000 	MEM[098] : 0x00000000 	MEM[099] : 0x00000000 	
MEM[100] : 0x00000000 	MEM[101] : 0x00000000 	MEM[102] : 0x00000000 	MEM[103] : 0x00000000 	
MEM[104] : 0x00000000 	MEM[105] : 0x00000000 	MEM[106] : 0x00000000 	MEM[107] : 0x00000000 	
MEM[108] : 0x00000000 	MEM[109] : 0x00000000 	MEM[110] : 0x00000000 	MEM[111] : 0x00000000 	
MEM[112] : 0x00000000 	MEM[113] : 0x00000000 	MEM[114] : 0x00000000 	MEM[115] : 0x00000000 	
MEM[116] : 0x00000000 	MEM[117] : 0x00000000 	MEM[118] : 0x00000000 	MEM[119] : 0x00000000 	
MEM[120] : 0x00000000 	MEM[121] : 0x00000000 	MEM[122] : 0x00000000 	MEM[123] : 0x00000000 	
MEM[124] : 0x00000000 	MEM[125] : 0x00000000 	MEM[126] : 0x00000000 	MEM[127] : 0x00000000 	
	*****************************************************************************
